


1111111111111111111111111111111111111111111111111
1E1C10100C10100C10100C10100C10100C10100C100C100C1
1010101010101010101010101010101010101010101010101
1010101010101010101010101010101010101010101010101
1010101010101010101010101010101010101010101010101
1010101010101010101010101010101010101010101010101
1010101010101010101010101010101010101010101010101
1010101010101010101010101010101010101010101010101
1010101010101010101010101010101010101010101010101
1010101010101010101010101010101010101010101010101
1010101010101010101010101010101010101010101010101
1010101010101010101010101010101010101010101010101
1010101010101010101010101010101010101010101010101
1010101010101010101010101010101010101010101010101
1010101010101010101010101010101010101010101010101
1010101010101010101010101010101010101010101010101
1010101010101010101010101010101010101010101010101
1010101010101010101010101010101010101010101010101
1010101010101010101010101010101010101010101010101
1010101010101010101010101010101010101010101010101
1010101010101010101010101010101010101010101010101
1010101010101010101010101010101010101010101010101
1010101010101010101010101010101010101010101010101
1C0P000010000010000010000010000010000010001000101
1111111111111111111111111111111111111111111111111



