11111111111
1E1010100C1
11101010101
100000P0101
11111111111
