11111111111
1E1C10100C1
10111010101
1C000P00101
11111111111
